MMMMMMMMMMMMMMM
M#############M
M#############M
M#############M
M#######TTTTT#M
M#######T###T#M
M#######T###TTM
M#######T###TTM
M#############M
M#############M
M########MMMM#M
M#########MM##M
M#############M
M#############M
MMMMMMMMMMMMMMM