MMMMMMMMMMMMMMM
M#############M
M#############M
M#############M
M#######AAAAA#M
M#######A###A#M
M#######A###AAM
M#######A###AAM
M#############M
M#############M
M########MMMM#M
M#########MM##M
M#############M
M#############M
MMMMMMMMMMMMMMM